BBBBBBBBBBBBBBBBBBBBBBBBBBBBBBBBBBBBBBBBBBBBBBBBBBBBBBBBBBBBBBBBBBBBBBBBBBBBBBBBBBBBBBBBBBBBBBBBBBBBBBBBBBBBBBBBBBBBBBBBBBBBBBBBBBBBBBBBBBBBBBBBBBBBBBBBBBBBBBBBBBBBBBBBBBBBBBBBBBBBBBBBBBBBBBBBBBBBBBBB
B                                 BBBBBBBBBBBBBBBBBBBBBBBBBBBBBBBBBBBBBBBBBBBBBBBBBBBBBBBBBBBBBBBBBBBBBBBBBBBBBBBBBBBBBBBBBBBBBBBBBBBBBBBBBBBBBBBBBBBBBB           BBBBBBBBBBBBBBBBBBBBBBBBB           B
B                                                                             BBBBBBBBBBB                       BBBBBBBBBBBBBBBBB                                       BBBBBBBBBBBBBB                 B
B                                                                                              P                                                                                                       B
B                                                                                        P P       P  P                                                                                                B
B                                                                             D                                   D                                                                                    B
B                                                                                       BBBBBB    BBBBBB                                                                                               B
B                                                                           P    D                             D    P                                                                                  B
B                                                                          BBBBBBBBB                        BBBBBBBBBBB                                                                                B
B                                                                                                                                                                                                      B
B                                                               P        D                                                                                                                             B
B                                                              BBBBBBBB                                                                                                                                B
B                               P                                           P                                       P    P                                            P P                              B
B                                                                                          P                       P      P                      D                         D                           B
B                                                 P  P  P  P                                                                                                                           D               B
B                                               BBBBBBBBBBBBBB            P  P                   P               P         P                                        BBBBBBBBB                          B
B           P         B  P   B  P    P   VBBBBBBBBBBBBBBBBBBBBBBBBBB   BBBBBBBBBB    B                      VBB                B      P      B          P          VB       B        B        B        B
BBBBBBBBBBBBBBBBBBBBBBBBBBBBBBBBBBBBBBBBBBBBBBBBBBBBBBBBBBBBBBBBBBBBBBBBBBBBBBBBBBBBBBBBBBBBBBBBBBBBBBBBBBBBBBBBBBBBBBBBBBBBBBBBBBBBBBBBBBBBBBBBBBBBBBBBBBBBBBBBBBBBBBBBBBBBBBBBBBBBBBBBBBBBBBBBBBBBBBBB